8,8,8,8,8,8,8,9,8,8,8,8,8,8,8,8
8,0,2,2,2,2,1,3,3,3,3,8,8,8,8,8
8,7,8,4,4,4,7,4,3,3,9,9,8,8,8,8
8,7,8,4,4,4,7,3,3,3,9,8,9,9,8,8
8,7,9,4,4,3,7,4,4,4,9,4,4,8,8,8
8,7,8,8,4,4,7,4,3,4,4,4,4,8,8,8
8,8,8,4,4,4,7,3,4,4,4,4,4,8,8,8
8,8,4,4,4,4,7,4,4,4,4,4,4,3,3,8
4,4,4,4,4,4,7,4,4,2,2,2,2,2,2,8
8,4,4,4,4,4,7,4,4,4,4,3,3,3,8,8
8,9,4,4,2,2,6,4,4,4,4,4,8,8,8,8
8,9,4,4,4,4,4,4,4,4,4,4,8,8,8,8
8,9,4,4,4,4,4,4,4,4,4,3,3,8,8,8
8,8,4,4,4,2,2,2,2,2,2,2,3,8,8,8
8,8,8,8,3,3,3,3,3,3,3,3,3,8,8,8
8,8,8,8,8,8,8,8,8,8,8,8,8,8,8,8
